t t g g g t t
 t w b b b t t
 w w b b b t t
 t w b b b w t
 t w b b b w t
 t t g g g t t
-
1 1 0 0 0 1 1
 1 1 0 0 0 1 1
 1 1 0 0 0 1 1
 1 1 0 0 0 1 1
 1 1 0 0 0 1 1
 1 1 0 0 0 1 1
-
0 0 7 1 7 0 0
 0 0 2 2 2 0 0
 0 0 2 2 2 0 0
 0 0 2 2 2 0 0
 0 0 2 2 2 0 0
 0 0 9 9 9 0 0