w w w g g t t
 t w g g g t t
 g g b b b g g
 g g b b b g g
 t t t t t t t
 t t t t t t t
-
1 1 1 0 0 1 1
 1 1 0 0 0 1 1
 0 0 0 0 0 0 0
 0 0 0 0 0 0 0
 1 1 1 1 1 1 1
 1 1 1 1 1 1 1
-
0 0 0 1 4 0 0
 0 0 0 0 0 0 0
 7 0 2 2 2 0 5
 7 0 2 2 2 0 5
 0 0 0 0 0 0 0
 0 0 0 0 0 0 0