t t t t t t t
 t t g g g t t
 t t g g g t t
 t t b b b t t
 t t w b b t t
 t t w g g t t
-
1 1 1 1 1 1 1
 1 1 0 0 0 1 1
 1 1 0 0 0 1 1
 1 1 0 0 0 1 1
 1 1 1 0 0 1 1
 1 1 1 0 0 1 1
-
0 0 0 0 0 0 0
 0 0 0 1 0 0 0
 0 0 0 0 0 0 0
 0 0 2 2 2 0 0
 0 0 0 2 2 0 0
 0 0 3 3 3 0 0