t t t t t t t
 t t t t t t t
 t t g g g t t
 t t g g g t t
 t t g g g t t
 t t g g g t t
-
1 1 1 1 1 1 1
 1 1 1 1 1 1 1
 1 1 0 0 0 1 1
 1 1 0 0 0 1 1
 1 1 0 0 0 1 1
 1 1 0 0 0 1 1
-
0 0 0 0 0 0 0
 0 0 0 0 0 0 0
 0 0 0 0 0 0 0
 0 0 0 0 0 0 0
 0 0 0 0 0 0 0
 0 0 5 1 5 0 0