t t t t t t t
 t t t t t t t
 t t g b g g g
 t t b g b g g
 t t g b g t t
 t t b g b t t
-
1 1 1 1 1 1 1
 1 1 1 1 1 1 1
 1 1 0 0 0 0 0
 1 1 0 0 0 0 0
 1 1 0 0 0 1 1
 1 1 0 0 0 1 1
-
0 0 0 0 0 0 0
 0 0 0 0 0 0 0
 0 0 0 2 0 0 1
 0 0 2 0 2 0 3
 0 0 0 2 0 0 0
 0 0 2 8 2 0 0