t t g g g t t
 t t b b b t t
 t t b b b t t
 g g b b b t t
 g g g b b t t
 t t t t t t t
-
1 1 0 0 0 1 1
 1 1 0 0 0 1 1
 1 1 0 0 0 1 1
 0 0 0 0 0 1 1
 0 0 0 0 0 1 1
 1 1 1 1 1 1 1
-
0 0 6 6 6 0 0
 0 0 2 2 2 0 0
 0 0 2 2 2 0 0
 3 0 2 2 2 0 0
 1 0 0 2 2 0 0
 0 0 0 0 0 0 0