t t g g g t t
 t g g g g g t
 t g g g g g t
 w g g g g g w
 w w g g g w w
 w w w w w w w
-
1 1 0 0 0 1 1
 1 0 0 0 0 0 1
 1 0 0 0 0 0 1
 1 0 0 0 0 0 1
 1 1 0 0 0 1 1
 1 1 1 1 1 1 1
-
0 0 8 1 8 0 0
 0 0 0 10 0 0 0
 0 0 0 0 0 0 0
 0 0 0 0 0 0 0
 0 0 0 0 0 0 0
 0 0 0 0 0 0 0